#############
#1.c.cc..c..#
#.#c#.#.#.#.#
#c.rrrrrrr..#
#c#c#c#.#.#.#
#..c...c..r.#
#.#c#c#.#.#.#
#c.rr..rr.c.#
#.#c#.#.#c#.#
#.cc.cc.rr.2#
#############