#######
#1cc..#
#.#.#.#
#c.c..#
#.#.#.#
#ccc.2#
#######