#############
#1.c.cc..c..#
#.#c#.#.#.#.#
#c.c..cccc..#
#c#c#c#.#.#.#
#..c...c....#
#.#c#c#.#.#.#
#c.c...c..c.#
#.#c#.#.#c#.#
#.cc.cc.cc.2#
#############